RadioengeLoraMesh 	KEYWORD1
begin 	KEYWORD2
available 	KEYWORD2
readBytes 	KEYWORD2
setResponseTimeout 	KEYWORD2
localReadAsync 	KEYWORD2
pinModeAsync 	KEYWORD2
digitalWriteAsync 	KEYWORD2	
awaitForResponse 	KEYWORD2
localRead 	KEYWORD2
pinMode 	KEYWORD2
digitalWrite 	KEYWORD2
readMessage 	KEYWORD2
radio_result_t 	KEYWORD1
radio_pull_t 	KEYWORD1
radio_mode_t 	KEYWORD1
packet_t 	KEYWORD1
device_t 	KEYWORD1
RADIO_ID_LSB_POS 	KEYWORD1
RADIO_ID_MSB_POS 	LITERAL1
RADIO_CMD_POS 	LITERAL1
RADIO_DATA_POS 	LITERAL1
RADIO_OK 	LITERAL1
RADIO_ERROR 	LITERAL1
RADIO_TIMEOUT_ERROR 	LITERAL1
RADIO_GPIO0 	LITERAL1
RADIO_GPIO1 	LITERAL1
RADIO_GPIO2 	LITERAL1
RADIO_GPIO3 	LITERAL1
RADIO_GPIO4 	LITERAL1
RADIO_GPIO5 	LITERAL1
RADIO_GPIO6 	LITERAL1
RADIO_GPIO7 	LITERAL1